0,0,0,0,0,0,0,0,0,0,0,0,0,0
0,1145,1146,0,1124,1125,1124,1125,0,0,0,0,0,0
0,1153,1154,0,1132,1133,1132,1133,1340,0,0,0,0,0
0,0,0,0,0,0,1385,1386,0,0,0,0,0,0
0,0,1537,1539,0,0,0,0,0,0,0,0,0,0
0,0,0,1567,0,0,0,0,0,0,0,0,0,0
0,0,0,0,0,0,0,0,0,0,0,0,0,0
0,0,0,0,0,0,0,0,0,0,0,0,0,0
0,0,0,0,0,0,0,0,0,0,0,0,0,0
0,0,0,0,0,0,0,0,0,0,0,0,0,0
0,0,0,0,0,0,0,0,0,0,0,0,0,0
