0,0,0,0,0,0,0,0,0,0,0,0,0,0
0,0,0,0,0,0,0,0,0,0,1801,1801,1801,0
0,0,0,0,0,0,0,0,0,0,1809,1809,1850,0
0,0,0,0,0,0,0,0,0,0,833,834,835,0
0,0,0,0,0,1090,0,0,0,0,849,850,851,0
0,0,0,0,0,1098,0,0,1093,1094,0,0,0,0
0,0,0,1575,0,0,0,0,1101,1102,0,0,0,0
0,0,0,0,0,0,0,0,0,0,1103,1104,0,0
0,1241,0,1243,0,1243,0,1243,0,1245,0,0,0,0
0,1249,0,1251,0,1251,0,1251,0,1253,0,0,0,0
0,0,0,0,0,0,0,0,0,0,0,0,0,0
