0,0,0,0,0,0,0,0,0,0,0,0,0,0
0,0,0,0,0,0,0,0,0,0,1801,1801,1801,0
0,1809,1814,0,1850,1850,1850,1850,1810,0,1809,1809,1850,0
0,1161,1162,1472,1140,1141,1140,1141,1348,0,833,834,835,0
0,1169,1170,1514,0,1090,1393,1394,0,0,849,850,851,0
0,0,0,0,0,1472,0,0,1093,1094,0,0,0,0
0,0,0,1575,0,0,0,0,1101,1102,0,0,0,0
0,0,0,1472,0,0,0,0,0,0,1103,1104,0,0
0,1241,0,1243,0,1243,0,1243,0,1245,0,0,0,0
0,1249,0,1251,0,1251,0,1251,0,1253,0,0,0,0
0,0,0,0,0,0,0,0,0,0,0,0,0,0
