0,0,0,0,0,0,0,0,0,0,0,0,0,0
0,1310,1311,1310,1310,1311,1311,1311,1310,0,0,0,0,0
0,1318,1319,1318,1318,1319,1319,1319,1318,0,0,0,0,0
0,0,0,0,0,0,0,0,0,0,0,0,0,0
0,0,0,0,0,0,0,0,0,0,0,0,0,0
0,0,0,0,0,0,0,0,0,0,0,0,0,0
0,0,1650,1651,1651,1651,1651,1651,1651,1651,1651,1652,0,0
0,0,0,0,0,0,0,0,0,0,0,0,0,0
0,0,0,0,0,0,0,0,0,0,0,0,0,0
0,0,0,0,0,0,0,0,0,0,0,0,0,0
0,0,0,0,0,0,0,0,0,0,0,0,0,0
