0,0,0,0,0,0,0,0,0,0,0,0,0,0
0,0,0,0,0,0,0,0,0,0,1801,1801,1801,0
0,1809,1814,1815,1850,1850,1850,1850,1810,0,1809,1809,1850,0
0,1326,1326,1326,1326,1326,1326,1326,1326,0,764,765,766,0
0,0,0,0,0,0,0,0,0,0,780,781,782,0
0,0,0,0,0,0,0,0,0,0,0,0,0,0
0,0,0,0,0,0,0,0,0,0,0,0,0,0
0,0,0,0,0,0,0,0,0,0,0,0,0,0
0,0,0,0,0,0,0,0,0,0,0,0,0,0
0,0,0,0,0,0,0,0,0,0,0,0,0,0
0,0,0,0,0,0,0,0,0,0,0,0,0,0
