0,0,0,0,0,0,0,0,0,0,0,0,0,0
0,0,0,0,0,0,0,0,0,0,0,0,0,0
0,0,0,0,0,0,0,0,0,0,0,0,0,0
0,711,711,711,711,711,711,711,711,711,711,711,711,0
0,711,703,703,703,703,703,703,703,703,703,703,703,241
0,711,703,703,703,703,703,703,703,703,703,703,703,241
0,711,703,703,703,703,703,703,703,703,703,703,703,241
0,711,703,703,703,703,703,703,703,703,703,703,703,0
0,711,703,703,703,703,703,703,703,703,703,703,703,0
0,711,703,703,703,703,703,703,703,703,703,703,703,0
0,0,0,0,0,0,0,0,0,0,0,0,0,0
