0,0,0,0,0,0,0,0,0,0,0,0,0,0
0,0,0,1108,1109,1384,0,1121,1122,1329,0,0,1384,0
0,1186,1187,1116,1117,0,0,0,0,0,0,1388,1392,0
0,1387,1388,0,0,0,0,0,0,0,0,0,1388,0
0,1387,1382,1382,0,0,0,0,0,0,0,0,1384,0
0,1383,1390,1390,1383,1478,1479,1333,1472,1384,0,0,1392,0
0,1391,1388,1388,0,1486,1487,0,0,0,0,1388,1387,0
0,1388,0,0,0,0,0,0,0,0,0,0,1389,0
0,1388,0,0,0,0,0,0,0,0,0,0,1389,0
0,1388,0,0,0,0,0,0,0,1389,1387,1387,1389,0
0,0,0,0,0,0,0,0,0,0,0,0,0,0
0,0,0,0,0,0,0,0,0,0,0,0,0,0
