0,0,0,0,0,0,0,0,0,0,0,0,0,0,0,0,0
0,0,280,0,49,50,0,0,0,51,52,0,216,0,255,0,0
0,0,0,185,57,58,0,0,0,59,60,0,224,185,0,0,0
0,0,0,0,0,0,0,0,0,0,0,0,200,223,0,0,0
0,0,0,223,187,187,218,187,187,187,187,187,187,231,0,0,0
0,0,0,231,0,0,0,0,0,0,0,0,0,0,0,0,0
0,0,0,0,0,250,0,0,0,0,0,249,0,0,0,0,0
0,0,0,0,0,0,0,0,0,0,0,0,0,0,0,0,0
0,0,0,0,0,0,0,0,0,0,0,0,0,0,0,0,0
0,0,0,0,0,0,0,0,0,0,0,0,0,0,0,0,0
0,0,0,0,0,0,0,0,0,0,0,0,0,0,0,0,0
0,0,0,0,0,0,0,0,0,0,0,0,0,0,0,0,0
