0,0,0,0,0,0,0,0,0,0,0,0,0,0,0,0,0
0,0,0,0,0,0,0,0,0,0,0,0,0,0,0,0,0
0,0,10,0,0,0,0,0,0,0,0,0,0,0,10,0,0
0,0,296,0,198,199,0,0,0,0,0,0,0,0,271,0,0
0,0,0,0,206,207,0,0,0,0,0,0,0,0,0,0,0
0,0,0,0,0,0,0,0,0,0,0,0,0,0,0,0,0
0,0,0,0,0,0,0,0,0,0,0,0,0,0,0,0,0
0,0,0,0,0,0,0,102,103,104,0,0,0,0,0,0,0
0,0,152,0,0,0,0,110,111,112,0,0,0,0,149,0,0
0,0,0,0,0,0,0,118,119,120,0,0,0,0,0,0,0
0,0,0,0,0,0,0,169,170,171,0,0,0,0,0,0,0
0,0,0,0,0,0,0,0,0,0,0,0,0,0,0,0,0
