0,0,0,0,0,0,0,0,0,0,0,0,0,0,0,0,0,0,0,0
0,0,0,0,0,0,0,0,0,0,0,0,0,0,0,0,0,0,0,0
0,0,0,0,0,0,0,0,0,0,0,0,0,0,0,0,0,0,0,0
0,0,0,0,0,0,0,0,0,0,0,0,0,0,0,0,0,0,0,0
0,0,0,0,0,0,2721,2722,2723,0,2721,2722,2723,0,2721,2722,2723,0,0,0
0,0,0,0,0,0,0,0,0,0,0,0,0,0,2670,2671,2670,2671,0,0
0,0,0,0,0,0,0,0,0,0,0,0,0,0,2678,2679,2678,2679,0,0
0,0,0,0,0,0,0,0,0,0,0,0,0,0,2678,2679,2678,2679,0,0
0,0,0,862,863,864,0,0,0,0,0,0,0,0,2686,2687,2686,2687,0,0
0,0,0,0,0,0,0,0,0,0,0,0,0,0,0,0,0,0,0,0
