159,159,159,159,159,159,159,159,159,159,159,159,159,159,159,159,159,159,159,159
159,2394,2394,2394,2394,2393,2394,2394,2394,2393,2394,2394,2394,2393,2394,2394,2394,2394,2394,159
159,2402,2402,2402,2402,2401,2402,2402,2402,2401,2402,2402,2402,2402,2402,2402,2401,2402,2402,159
159,2350,2351,2350,2351,2071,2713,2714,2715,2071,2713,2714,2715,2071,2713,2714,2715,0,2420,159
159,0,0,0,0,0,0,0,0,0,0,0,0,0,0,0,0,0,2428,159
159,3045,3046,0,0,0,0,0,0,0,0,0,0,0,0,0,0,0,2420,159
159,3053,3054,0,0,0,0,0,0,0,0,0,0,0,0,0,0,0,2428,159
159,0,0,0,0,0,2014,2015,0,0,2024,2014,2015,0,0,0,0,0,2420,159
159,0,0,0,0,0,2022,2023,2016,0,0,2022,2023,0,0,0,0,0,2428,159
159,159,159,870,871,872,159,159,159,159,159,159,159,159,159,159,159,159,159,159
