0,0,0,0,0,0,0,0,0,0,0,0,0,0
0,0,0,0,0,0,0,0,0,0,1801,1801,1801,0
0,0,1814,0,1850,0,1850,0,1810,1811,1809,1809,1850,0
0,0,1181,0,1181,0,1182,0,1181,1398,833,834,835,0
0,0,0,0,0,0,0,0,0,0,849,850,851,0
0,0,0,0,0,0,0,0,0,0,0,0,0,0
0,0,1689,1690,1690,1690,1690,1690,1691,0,0,0,0,0
0,0,1575,1575,1575,1575,1575,1575,1575,0,0,0,0,0
0,1241,0,1243,0,1243,0,1243,0,1245,0,0,0,0
0,1249,0,1251,0,1251,0,1251,0,1253,0,0,0,0
0,0,0,0,0,0,0,0,0,0,0,0,0,0
