0,0,0,0,0,0,0,0,0,0,0,0,0,0
0,0,0,0,0,0,0,0,0,0,0,0,0,0
0,0,0,0,0,0,0,0,0,0,0,0,0,0
0,654,654,654,654,654,654,654,654,654,654,654,654,0
0,654,645,645,645,645,645,645,645,645,645,645,645,241
0,654,645,645,645,345,645,645,645,645,645,645,645,241
0,654,645,645,645,645,645,645,645,645,645,645,645,241
0,654,645,645,645,645,645,645,645,645,645,645,645,0
0,654,645,645,645,645,645,645,645,645,645,645,645,0
0,654,645,645,645,645,345,645,645,645,645,645,645,0
0,0,0,0,0,0,0,0,0,0,0,0,0,0
