0,0,0,0,0,0,0,0,0,0,0,0,0,0,0
0,27,28,29,767,768,767,768,0,0,0,0,0,0,0
0,0,0,0,0,0,0,0,70,54,55,55,55,75,0
0,0,26,0,0,25,0,0,0,0,0,0,0,398,0
0,0,0,0,0,0,0,53,0,8,0,0,0,0,0
0,0,0,0,0,0,0,0,0,16,55,55,74,75,0
0,0,0,0,0,0,0,0,0,0,0,0,0,0,0
0,0,26,0,0,25,0,0,0,0,0,0,0,0,0
0,0,0,0,0,0,0,0,0,0,0,0,0,0,0
0,0,0,0,0,0,0,0,0,0,0,0,0,0,0
0,0,0,0,0,0,0,0,0,57,59,59,60,0,0
0,0,0,0,0,0,0,0,0,0,0,0,0,0,0
0,0,0,0,0,0,0,0,0,0,0,0,0,0,0
0,0,0,0,0,0,0,0,0,0,0,0,0,0,0
