0,0,0,0,0,0,0,0,0,0,0,0,0,0,0
0,0,0,0,0,0,0,0,0,0,0,0,0,0,0
0,0,0,0,0,0,0,0,0,0,0,0,0,0,0
0,17,9,17,9,17,9,17,9,17,9,17,9,17,0
0,9,17,9,17,9,17,9,17,9,17,9,17,9,0
0,17,9,17,9,17,9,17,9,17,9,17,9,17,0
0,9,17,9,17,9,17,9,17,9,17,9,17,9,0
0,17,9,17,9,17,9,17,9,17,9,17,9,17,0
0,9,17,9,17,9,17,9,17,9,17,9,17,9,0
0,17,9,17,9,17,9,17,9,17,9,17,9,17,0
0,9,17,9,17,9,17,9,17,9,17,9,17,9,0
0,17,9,17,9,17,9,17,9,17,9,17,9,17,0
0,9,17,9,17,9,17,9,17,9,17,9,17,9,0
0,0,0,0,0,0,0,0,0,0,0,0,0,0,0
