5,5,5,5,5,5,5,5,5,5,5,5,5,5,5
5,3,3,3,3,3,3,3,3,3,3,3,3,3,5
5,35,36,37,775,776,775,776,11,11,11,11,11,11,5
5,0,0,0,0,0,0,0,78,30,47,47,47,83,5
5,0,34,0,0,87,0,0,0,40,432,0,0,406,5
5,0,42,0,0,95,0,61,0,38,0,0,432,0,5
5,0,50,0,0,103,0,61,0,46,47,47,82,83,5
5,0,0,0,0,0,0,61,0,0,0,0,0,0,5
5,0,88,0,0,33,0,61,0,0,0,0,0,0,5
5,0,96,0,0,41,0,69,0,0,0,0,0,0,5
5,0,104,0,0,49,0,0,0,0,0,0,0,0,5
5,0,0,0,0,0,0,0,0,65,67,67,68,0,5
5,0,0,0,0,0,0,0,0,0,0,0,0,0,5
5,5,5,20,21,22,5,5,5,5,5,5,5,5,5
