0,0,0,0,0,0,0,0,0,0,0,0,0,0,0,0,0
0,0,0,0,0,0,0,216,331,332,0,0,0,0,0,0,0
0,0,303,273,274,277,278,0,339,340,273,274,277,278,303,279,0
0,0,0,0,0,0,0,0,0,0,0,0,0,0,618,287,0
0,0,0,0,0,0,0,0,0,0,0,0,0,0,626,0,0
0,0,0,0,0,0,0,0,0,0,0,0,0,0,0,0,0
0,0,0,0,0,0,0,0,0,0,0,0,0,0,0,0,0
0,0,0,0,0,0,0,0,0,0,0,0,0,0,0,0,0
0,0,0,0,0,0,0,0,0,0,0,0,0,0,0,0,0
0,0,0,0,0,0,0,0,0,0,0,0,0,0,0,0,0
0,368,368,368,368,368,368,368,368,368,368,368,368,368,368,368,0
0,0,0,0,0,0,0,0,0,0,0,0,0,0,0,0,0
