0,0,0,0,0,0,0,0,0,0,0,0,0,0,0
0,2334,2335,0,0,2038,0,2076,2081,0,2076,2090,0,2624,0
0,2342,2343,2359,2360,0,2705,2706,2707,2063,2705,2706,2416,2632,0
0,0,0,0,0,0,0,1480,0,0,0,1514,2424,0,0
0,2181,2182,0,0,0,0,0,0,0,0,0,0,0,0
0,0,0,0,0,0,0,0,0,0,0,0,0,0,0
0,0,0,0,0,0,0,0,0,0,0,0,0,0,0
0,0,0,0,0,0,0,2886,2887,0,0,0,0,0,0
0,0,0,0,0,0,2887,2894,2895,2886,0,0,0,0,0
0,0,0,0,0,0,0,0,0,0,0,0,0,0,0
