0,0,0,0,0,0,0,0,0,0,0,0,0,0,0
0,0,0,0,0,0,0,0,0,0,0,0,0,0,0
0,0,0,0,0,0,0,0,0,0,0,0,0,0,0
0,2781,2782,2782,2782,2782,2782,2782,2782,2782,2782,2782,2782,2782,2782
0,2789,2521,2521,2521,2521,2521,2521,2521,2521,2521,2521,2521,2521,2521
0,2789,2521,2521,2521,2521,2521,2521,2521,2521,2521,2521,2521,2521,2521
0,2789,2521,2521,2521,2521,2521,2521,2521,2521,2521,2521,2521,2521,2521
0,2789,2521,2521,2521,2521,2521,2521,2521,2521,2521,2521,2521,2521,2521
0,2789,2521,2521,2521,2521,2521,2521,2521,2521,2521,2521,2521,2521,2521
0,250,241,241,241,241,241,241,241,241,241,241,241,0,0
