0,0,0,0,0,0,0,0,0,0,0,0,0,0
0,0,0,1057,0,0,1079,0,0,0,0,0,0,0
0,1359,1617,1065,0,0,1087,1617,0,0,0,0,0,0
0,0,1333,1619,1619,1619,1619,1354,0,0,0,0,0,0
0,0,0,0,0,0,0,1362,0,0,0,0,0,0
0,0,0,0,0,0,0,0,0,0,0,0,0,0
0,0,0,0,0,0,0,0,0,0,0,0,0,0
0,0,0,0,0,0,0,1262,1263,1264,0,0,0,0
0,0,0,0,0,0,0,1730,1731,1732,0,0,0,0
0,0,0,0,0,0,0,0,0,0,0,0,0,0
0,0,0,0,0,0,0,0,0,0,0,0,0,0
