0,0,0,0,0,0,0,0,0,0,0,0,0,0
0,0,0,0,0,0,1405,1406,1407,0,0,0,0,0
0,1625,0,1625,1411,1412,1413,0,0,0,0,0,0,0
0,1514,0,1341,0,0,0,1369,1370,0,0,0,0,0
0,1491,0,1472,0,0,0,0,0,0,0,0,0,0
0,1499,0,1177,0,0,0,0,0,0,0,0,0,0
0,1520,0,0,0,0,1618,1619,1619,1619,1620,0,0,0
0,0,0,0,0,0,0,1425,1426,0,1388,0,0,0
0,0,0,0,0,0,0,0,0,0,0,0,0,0
0,0,0,0,0,0,0,0,0,0,0,0,0,0
0,0,0,0,0,0,0,0,0,0,0,0,0,0
