0,0,0,0,0,0,0,0,0,0,0,0,0,0
0,0,0,0,0,0,0,0,0,0,1801,1801,1801,0
0,0,0,0,1850,1850,1850,0,0,0,1809,1809,1850,0
0,0,0,0,1419,1420,1421,0,0,0,761,762,763,0
0,0,0,0,0,0,0,0,0,0,777,778,779,0
0,0,0,0,0,0,0,0,0,0,0,0,0,0
0,0,0,0,0,0,0,0,0,0,0,0,0,0
0,0,0,0,0,0,0,0,0,0,0,0,0,0
0,0,0,0,0,0,0,0,0,0,0,0,0,0
0,0,0,0,0,0,0,0,0,0,0,0,0,0
0,0,0,0,0,0,0,0,0,0,0,0,0,0
