0,0,0,0,0,0,0,0,0,0,0,0,0,0
0,0,0,0,0,0,0,0,0,0,0,0,0,0
0,0,0,0,0,0,0,0,0,0,0,0,0,0
0,322,322,322,322,322,322,322,322,322,322,322,322,0
0,322,313,313,313,313,313,313,313,313,313,313,313,241
0,322,313,313,313,313,313,313,313,313,313,313,313,241
0,322,313,313,313,313,313,313,313,313,313,313,313,241
0,322,313,313,313,313,313,313,313,313,313,313,313,0
0,322,313,313,313,313,313,313,313,313,313,313,313,0
0,322,313,313,313,313,313,313,313,313,313,313,313,0
0,0,0,0,0,0,0,0,0,0,0,0,0,0
