0,0,0,0,0,0,0,0,0,0,0,0,0,0
0,0,0,0,0,0,0,0,0,0,1801,1801,1801,0
0,0,0,0,0,0,0,0,0,0,1809,1809,1850,0
0,1241,0,1243,0,1243,0,1243,0,1245,0,0,0,0
0,1249,0,1251,0,1251,0,1251,0,1253,0,0,0,0
0,836,837,837,837,837,837,837,837,837,838,0,0,0
0,844,845,845,845,845,845,845,845,845,846,0,0,0
0,852,853,853,853,853,853,853,853,853,854,0,0,0
0,1241,0,1243,0,1243,0,1243,0,1245,0,0,0,0
0,1249,0,1251,0,1251,0,1251,0,1253,0,0,0,0
0,0,0,0,0,0,0,0,0,0,0,0,0,0
