0,0,0,0,0,0,0,0,0,0,0,0,0,0
0,0,0,0,0,0,0,0,0,0,0,0,0,0
0,0,0,0,0,0,0,0,0,0,0,0,0,0
0,354,354,354,354,354,354,354,354,354,354,354,354,0
0,354,345,345,345,345,345,345,345,345,345,345,345,241
0,354,345,345,345,345,345,345,345,345,345,345,345,241
0,354,345,345,345,345,345,345,345,345,345,345,345,241
0,354,345,345,345,345,345,345,345,345,345,345,345,0
0,354,345,345,345,345,345,345,345,345,345,345,345,0
0,354,345,345,345,345,345,345,345,345,345,345,345,0
0,0,0,0,0,0,0,0,0,0,0,0,0,0
