0,0,0,0,0,0,0,0,0,0,0,0,0,0
0,0,1108,1109,0,1149,1150,1108,1109,0,1176,0,0,0
0,0,1116,1117,0,0,0,1116,1117,0,0,0,0,0
0,0,0,0,0,0,0,0,0,0,0,0,0,0
0,151,151,151,151,151,151,151,151,151,151,151,151,0
0,1123,1058,1059,1057,1126,1126,0,35,0,1107,1107,1311,0
0,0,1066,1067,1065,0,0,0,0,0,1115,1115,0,0
0,0,0,0,0,1277,1278,0,0,1204,1205,1206,1207,0
0,0,0,0,0,0,0,0,0,0,0,0,0,0
0,0,0,0,0,0,0,0,0,0,0,0,0,0
0,0,0,0,0,0,0,0,0,0,0,0,0,0
0,0,0,0,0,0,0,0,0,0,0,0,0,0
