0,0,0,0,0,0,0,0,0,0,0,0,0,0
0,0,0,0,0,0,0,0,0,0,0,0,0,0
0,41,0,0,0,41,41,0,0,0,41,41,41,0
0,1181,0,0,0,1165,1166,0,0,0,1192,1194,1195,0
0,0,0,0,0,0,0,0,0,0,0,0,0,0
0,0,0,0,0,0,0,0,0,0,0,0,0,0
0,41,0,0,0,41,41,0,43,0,0,0,41,0
0,1139,0,0,0,1142,1142,0,0,0,0,0,1327,0
0,0,0,0,0,0,0,0,0,1212,0,0,1215,0
0,0,0,0,0,0,0,0,0,1220,0,0,1223,0
0,0,862,863,864,0,0,0,0,0,0,0,0,0
0,0,0,0,0,0,0,0,0,0,0,0,0,0
