0,0,0,0,0,0,0,0,0,0,0,0,0,0
0,1151,1152,0,1151,1152,1151,1152,0,0,0,0,0,0
0,0,0,1752,0,0,0,0,0,0,0,0,0,0
0,1797,0,0,0,0,0,0,0,0,0,0,0,0
0,1127,1128,1333,1124,1125,1124,1125,1126,0,0,0,0,0
0,0,0,1488,1277,1278,1277,1278,1310,0,0,0,0,0
0,1126,1126,1514,0,0,0,0,0,0,0,1176,1176,0
0,0,0,0,0,0,0,0,0,0,0,0,0,0
0,0,0,0,0,0,0,0,0,0,0,0,0,0
0,0,0,0,0,0,0,0,0,0,0,0,0,0
0,0,0,0,0,0,0,0,0,0,0,0,0,0
