0,0,0,0,0,0,0,0,0,0,0,0,0,0
0,0,0,0,0,0,0,0,0,0,1801,1801,1801,0
0,1809,1814,0,1850,1850,1850,1850,0,1811,1809,1809,1850,0
0,1167,1168,0,1167,1168,1167,1168,0,1181,809,810,811,0
0,0,0,0,0,0,0,0,0,0,817,818,819,0
0,0,0,0,0,0,0,0,0,0,825,826,827,0
0,1167,1168,0,0,0,0,0,1142,0,0,0,0,0
0,0,0,0,0,0,0,0,1326,0,0,0,0,0
0,1142,1142,1560,0,0,0,0,0,0,0,1192,1192,0
0,0,0,0,0,0,0,0,0,0,0,0,0,0
0,0,0,0,0,0,0,0,0,0,0,0,0,0
