0,0,0,0,0,0,0,0,0,0,0,0,0,0
0,0,0,0,0,0,0,0,0,0,1801,1801,1801,0
0,0,0,0,0,0,0,0,0,0,1809,1809,1850,0
0,0,0,0,0,0,0,0,0,0,809,810,811,0
0,0,0,0,0,0,0,0,0,0,817,818,819,0
0,0,0,0,0,0,0,0,0,0,825,826,827,0
0,0,0,0,0,0,0,0,0,0,0,0,0,0
0,0,0,1560,0,0,0,0,0,0,0,0,0,0
0,0,0,0,0,0,0,0,0,0,0,0,0,0
0,0,0,0,0,0,0,0,0,0,0,0,0,0
0,0,0,0,0,0,0,0,0,0,0,0,0,0
