0,0,0,0,0,0,0,0,0,0,0,0,0,0
0,0,0,0,0,0,0,0,0,0,0,0,0,0
0,25,25,25,25,0,25,0,0,0,0,25,0,0
0,1194,1195,1163,1164,0,1181,0,0,0,904,906,0,0
0,0,0,0,0,0,0,0,0,0,912,0,0,0
0,0,0,0,812,813,813,813,813,814,0,0,0,0
0,0,0,0,820,821,821,821,821,822,0,0,1346,0
0,0,0,0,828,829,829,829,829,830,0,0,0,0
0,0,0,0,0,0,0,0,0,0,0,0,0,0
0,0,0,0,0,0,0,0,0,0,0,0,0,0
0,0,0,862,863,864,0,0,0,0,0,0,0,0
0,0,0,0,0,0,0,0,0,0,0,0,0,0
