0,0,0,0,0,0,0,0,0,0,0,0
0,2334,2335,2038,2348,0,2329,2330,2331,2039,2040,0
0,2342,2343,0,0,0,2337,2338,2339,2047,2048,0
0,2063,0,0,1510,0,0,2399,0,0,0,0
0,0,0,0,0,0,0,0,0,0,0,0
0,2063,0,0,0,0,0,0,0,0,0,0
0,0,0,0,0,0,0,0,0,0,0,0
0,2063,0,0,0,0,0,0,0,0,0,0
0,0,0,0,0,0,0,0,0,0,0,0
0,0,0,0,0,0,0,0,0,0,0,0
