159,159,159,159,159,159,159,159,159,159,159,159
159,2394,2394,2394,2394,2393,2394,2394,2394,2393,2394,159
159,2402,2402,2046,2402,2401,2402,2402,2402,2401,2402,159
159,2350,2351,0,0,0,0,0,0,2055,2056,159
159,2071,0,0,1518,2298,2298,2407,0,0,1177,159
159,0,0,0,0,2024,0,0,0,0,0,159
159,2071,0,0,0,0,0,0,0,0,0,159
159,0,0,0,0,0,0,0,2014,2015,0,159
159,2071,0,0,0,0,0,2024,2022,2023,2016,159
159,159,870,871,872,159,159,159,159,159,159,159
