0,0,0,0,0,0,0,0,0,0,0,0,0,0
0,0,0,0,0,0,0,0,0,0,0,0,0,0
0,25,0,0,0,0,0,0,0,0,0,25,0,0
0,1139,0,0,0,0,0,0,0,0,904,906,0,0
0,0,0,0,0,0,0,0,0,0,912,0,0,0
0,0,0,788,789,789,789,789,789,790,0,0,0,0
0,0,0,796,797,797,797,797,797,798,0,0,0,0
0,0,0,796,797,797,797,797,797,798,0,0,0,0
0,0,0,804,805,805,805,805,805,806,0,0,0,0
0,0,0,0,0,0,0,0,0,0,0,0,0,0
0,0,0,862,863,864,0,0,0,0,0,0,0,0
0,0,0,0,0,0,0,0,0,0,0,0,0,0
