0,0,0,0,0,0,0,0,0,0,0,0,0,0,0,0,0,0
0,1126,1106,1126,1106,1126,1106,1126,1061,1062,1126,1106,1126,1106,1126,1106,1126,0
0,0,1114,0,1114,0,1114,0,1069,1070,0,1114,0,1114,0,1114,0,0
0,0,0,0,0,0,0,0,1151,1152,0,0,0,0,0,0,0,0
0,0,0,0,0,1273,0,0,0,0,1389,0,1274,0,0,1273,0,0
0,0,0,1472,1514,0,0,0,0,0,0,0,0,0,1488,0,0,0
0,0,0,0,0,0,0,0,0,0,0,0,0,0,0,0,0,0
0,0,0,0,0,0,0,0,0,0,0,0,0,0,0,0,0,0
0,0,0,0,0,0,0,0,0,0,0,0,0,0,0,0,0,0
0,0,0,0,0,0,0,0,0,0,0,0,0,0,0,0,0,0
