0,0,0,0,0,0,0,0,0,0,0,0,0,0,0,0,0,0
0,0,0,0,0,0,0,0,0,0,0,0,0,0,0,0,0,0
0,11,0,11,0,11,0,11,0,0,11,0,11,0,11,0,11,0
0,1142,0,1142,0,1142,0,1142,0,0,1142,0,1142,0,1142,0,1142,0
0,0,0,0,0,0,0,785,786,786,787,0,0,0,0,0,0,0
0,0,0,0,0,0,0,793,1167,1168,795,0,0,0,0,0,0,0
0,0,0,0,0,0,0,801,802,802,803,0,0,0,0,0,0,0
0,0,0,0,0,0,0,0,0,0,0,0,0,0,0,0,0,0
0,0,0,0,862,863,864,0,0,0,0,0,0,0,0,0,0,0
0,0,0,0,0,0,0,0,0,0,0,0,0,0,0,0,0,0
