0,0,0,0,0,0,0,0,0,0,0,0,0,0
0,0,0,0,0,0,0,0,0,0,0,0,0,0
0,0,0,0,25,25,25,25,0,0,0,0,0,0
0,0,0,0,1139,1139,1161,1162,0,933,904,0,0,0
0,0,0,0,0,0,1169,1170,0,0,912,0,1796,0
0,0,0,0,0,0,0,1178,0,0,0,0,0,0
0,0,0,0,812,813,813,813,813,814,0,0,0,0
0,1225,0,1227,820,821,821,821,821,822,0,0,1567,0
0,1233,0,1235,828,829,829,829,829,830,0,0,1575,0
0,0,0,0,0,0,0,0,0,1488,0,0,1361,0
0,0,0,0,0,0,1480,1496,1512,1520,0,0,1347,0
0,0,0,0,0,0,0,0,0,0,0,0,0,0
