0,0,0,0,0,0,0,0,0,0,0,0,0,0,0,0,0
0,0,0,0,1176,0,0,1079,0,1121,1122,1330,1061,1062,0,0,0
0,0,0,0,0,0,0,1087,0,0,0,0,1069,1070,1389,0,0
0,875,0,0,0,0,0,1388,0,1262,1263,1264,0,0,0,874,0
0,0,0,0,0,0,0,0,0,0,0,0,0,0,0,0,0
0,1275,0,0,0,0,0,0,0,0,1514,1488,0,0,0,1355,0
0,0,0,0,0,0,0,0,0,0,0,0,0,0,0,0,0
0,0,1618,1619,1619,1619,1620,0,0,0,0,0,0,0,0,0,0
0,0,0,0,0,0,0,0,0,0,0,0,0,0,0,0,0
0,1314,0,0,0,0,0,0,0,0,0,0,0,0,0,1314,0
0,0,0,0,0,0,0,0,0,0,0,0,0,0,0,0,0
0,0,0,0,0,0,0,0,0,0,0,0,0,0,0,0,0
