0,0,0,0,0,0,0,0,0,0,0,0,0,0,0,0,0
0,0,0,0,0,0,0,0,0,0,0,0,0,0,0,0,0
0,0,146,146,146,146,146,0,0,146,146,146,0,0,0,0,0
0,0,1194,1195,1192,1181,1181,0,0,1137,1138,1346,0,0,1397,0,0
0,0,884,0,0,0,0,0,0,0,0,0,764,766,881,0,0
0,0,0,0,0,0,0,0,0,0,0,0,772,774,889,0,0
0,0,0,0,0,0,0,0,0,0,0,0,772,774,1362,0,0
0,0,0,0,0,0,0,0,0,0,0,0,772,774,0,0,0
0,0,0,0,0,0,0,0,0,0,0,0,780,782,0,0,0
0,0,0,0,0,0,0,0,0,0,0,0,0,0,0,0,0
0,0,0,0,0,0,0,862,863,864,0,0,0,0,0,0,0
0,0,0,0,0,0,0,0,0,0,0,0,0,0,0,0,0
