0,0,0,0,0,0,0,0,0,0,0,0,0,0
0,0,0,0,0,1077,1078,0,0,0,0,0,0,0
0,1387,1577,0,0,1085,1086,1577,1387,1388,0,0,0,0
0,0,1349,1579,1579,1579,1579,1507,0,0,0,0,0,0
0,0,0,0,0,0,0,1515,0,0,0,0,0,0
0,0,0,0,0,0,0,0,0,0,0,0,0,0
0,0,0,0,0,0,0,0,0,0,0,0,0,0
0,0,0,0,0,0,1274,0,0,1273,0,0,0,0
0,0,0,0,0,0,0,0,0,0,0,0,0,0
0,0,0,0,0,0,0,0,0,0,0,0,0,0
0,0,0,0,0,0,0,0,0,0,0,0,0,0
