0,0,0,0,0,0,0,0,0,0,0,0,0,0
0,1149,1150,0,0,0,1106,0,0,1106,1176,0,0,0
0,0,0,1259,1260,1261,1114,1388,1388,1114,0,0,0,0
0,0,0,0,0,0,0,0,0,0,0,0,0,0
0,151,151,151,151,151,151,152,0,0,0,0,0,0
0,1310,0,0,0,0,0,0,0,0,0,0,0,0
0,0,0,0,0,0,0,0,0,0,0,0,0,0
0,1201,1202,1203,0,0,0,0,0,0,0,0,0,0
0,0,0,0,0,0,0,0,0,0,0,0,0,0
0,0,0,0,0,0,0,0,0,0,0,0,0,0
0,0,0,0,0,0,0,0,0,0,0,0,0,0
0,0,0,0,0,0,0,0,0,0,0,0,0,0
