0,0,0,0,0,0,0,0,0,0,0,0,0,0
0,0,0,0,0,0,0,0,0,0,0,0,0,0
0,183,183,0,0,0,0,0,0,0,183,183,183,0
0,1165,1166,0,0,0,0,0,0,0,1192,1194,1195,0
0,0,0,0,0,0,0,0,0,0,0,0,0,0
0,0,0,0,0,0,0,0,833,834,834,834,835,0
0,183,0,0,0,0,0,0,841,842,842,842,843,0
0,1326,0,0,0,0,0,0,849,850,850,850,851,0
0,1209,0,1211,0,0,0,0,0,0,0,0,0,0
0,1217,0,1219,0,0,0,0,0,0,0,0,0,0
0,0,0,0,0,0,0,862,863,864,0,0,0,0
0,0,0,0,0,0,0,0,0,0,0,0,0,0
