542,0,677,4034,4035,4035,4035,4035,4023,4037,4020,0,0,0,0,0,0,0,0,0,0,556,557,558,0,0,0,0,0,0,0,0
550,607,678,687,687,687,687,671,4034,4035,4032,4019,4020,0,0,0,0,0,0,0,0,0,0,0,0,0,0,0,0,0,0,0
558,0,609,610,611,0,0,678,687,671,4034,4023,4037,4019,4020,0,0,0,0,0,0,0,0,0,0,0,0,0,0,0,0,0
540,541,542,0,609,610,611,607,0,678,671,4026,4027,4027,4028,0,0,0,0,0,0,0,0,0,0,0,0,0,0,0,0,0
548,549,550,607,0,0,0,0,0,607,677,4026,4027,4027,4037,4020,0,0,0,0,0,0,0,0,540,541,542,0,0,0,0,0
556,557,558,1825,1826,1827,1828,609,611,686,679,4026,4027,4027,4027,4037,4019,4019,4020,0,0,0,0,0,548,549,550,0,0,0,0,0
609,610,611,1849,1850,1851,1852,1316,1334,4018,4019,4039,4027,4027,4027,4027,4027,4027,4037,4019,4019,4020,0,0,556,557,558,0,0,0,0,0
0,1316,1334,1857,1858,0,1860,1327,4018,4039,4021,4035,4035,4035,4035,4035,4035,4035,4035,4023,4027,4037,4019,4020,0,0,0,0,0,0,0,0
1334,1327,0,0,0,0,0,4018,4039,4021,4036,540,541,542,687,688,1805,1806,1807,1808,4023,4027,4027,4037,4020,0,0,0,0,0,0,0
0,0,0,0,0,0,4018,4039,4021,4036,1826,1827,1828,550,0,0,1813,0,1815,1816,4034,4035,4035,4023,4037,4019,4020,0,0,0,0,0
0,0,0,0,4018,4019,4024,4035,4036,1833,1834,1835,1836,558,0,959,0,0,0,524,548,549,550,4026,4027,4027,4028,0,0,0,0,540
0,0,0,0,4026,4027,4028,1071,1072,1841,0,1843,1844,0,0,0,0,0,0,540,556,557,558,4034,4023,4027,4037,4020,0,0,0,548
0,0,0,0,0,0,0,0,0,0,0,0,0,0,0,0,0,0,0,548,549,550,0,0,4026,4027,4027,4028,0,0,0,556
542,0,0,0,0,0,0,0,0,0,0,0,0,0,1126,1127,1128,0,0,556,557,1825,1826,1827,4034,4023,4027,4028,0,0,0,0
550,0,0,0,4026,4027,4037,4020,1334,1334,1317,959,0,0,1134,1135,1136,0,0,959,0,1849,1850,1851,1852,4026,4027,4028,0,0,0,0
558,0,0,0,4034,4023,4021,4036,669,0,1328,0,0,0,1142,1143,1144,0,0,0,0,1857,1858,0,1860,4026,4027,4037,4020,0,0,0
0,0,0,0,0,4026,4028,670,679,0,1332,1319,0,0,0,0,0,0,0,0,0,0,0,0,0,4026,4027,4027,4037,4019,4020,0
0,0,0,0,0,4026,4028,677,0,0,0,1332,1319,0,0,0,0,0,0,0,0,0,0,669,4018,4039,4027,4027,4027,4027,4037,4019
0,0,0,0,0,4026,4028,678,671,0,0,0,1324,0,0,959,0,0,0,0,0,0,670,679,4026,4027,4027,4027,4027,4027,4027,4027
0,0,0,524,4018,4039,4037,4020,678,687,671,0,1332,1334,1319,0,0,0,0,0,0,670,679,4018,4039,4027,4021,4035,4035,4035,4035,4023
0,0,0,4018,4039,4027,4027,4037,4019,4020,678,687,671,0,1324,0,0,540,541,0,670,679,4018,4039,4027,4021,4036,0,0,0,0,4034
4019,4019,4019,4039,4021,4035,4035,4035,4023,4037,4019,4020,678,688,1324,0,0,548,549,550,685,4018,4039,4027,4021,4036,0,0,0,0,0,0
4027,4027,4027,4027,4028,0,0,540,4034,4035,4023,4037,4019,4020,1327,0,0,556,557,558,4018,4039,4021,4035,4036,0,0,0,0,0,0,670
4027,4021,4035,4035,4036,607,0,548,549,550,4034,4035,4035,4036,0,0,4018,4019,4019,4019,4039,4021,4036,0,0,0,0,670,687,687,687,679
4021,4036,548,549,550,0,0,556,557,558,949,0,0,0,0,0,4034,4023,4027,4027,4027,4028,0,0,0,670,687,679,0,0,0,0
4036,0,556,557,558,542,0,607,0,1318,1334,1334,1334,1334,1334,1334,669,4026,4027,4027,4021,4036,0,0,0,678,687,671,0,0,0,0
524,0,0,548,549,550,540,541,542,1333,609,611,0,607,670,687,1097,4026,4027,4027,4028,0,0,0,0,0,0,678,687,687,687,671
0,540,541,556,557,558,548,549,550,686,687,687,687,687,679,4018,4019,4039,4027,4027,4028,0,0,0,0,0,0,0,0,0,0,678
0,548,549,550,0,0,556,557,558,4018,4019,4019,4019,4019,4019,4039,4027,4027,4027,4027,4037,4020,0,0,0,0,0,0,0,0,0,0
0,556,557,558,0,4018,4019,4019,4019,4039,4027,4027,4021,4035,4035,4035,4035,4035,4035,4035,4035,4032,4019,4019,4019,4020,0,0,0,0,0,0
0,0,0,4018,4019,4039,4027,4021,4035,4035,4035,4035,4036,548,549,550,686,687,687,687,671,4034,4035,4035,4035,4032,4019,4019,4019,4020,0,0
0,524,4018,4039,4021,4035,4035,4036,548,549,550,0,0,556,557,558,0,0,0,0,540,541,542,687,688,4034,4035,4035,4023,4037,4020,0
