0,0,0,0,0,0,0,0,0,0,0,0,0,0,0
0,0,0,0,0,0,0,0,0,0,0,0,0,0,0
0,0,0,0,0,0,0,0,0,0,0,0,0,0,0
0,0,93,0,0,0,0,0,0,0,0,0,95,0,0
0,0,0,812,813,813,813,813,813,813,813,814,0,0,0
0,0,0,820,821,821,821,821,821,821,821,822,0,0,0
0,0,0,828,829,829,829,829,829,829,829,830,0,0,0
0,0,0,0,0,0,0,0,0,0,0,0,0,0,0
0,0,0,0,1692,1693,1693,1693,1693,1693,1694,0,0,0,0
0,0,0,0,0,0,0,0,0,0,0,0,0,0,0
0,0,0,0,0,0,862,863,864,0,0,0,0,0,0
0,0,0,0,0,0,0,0,0,0,0,0,0,0,0
