0,0,0,0,0,0,0,0,0,0,0,0,0,0,0
0,0,0,0,0,0,0,0,0,0,0,0,0,0,0
0,0,0,0,0,0,0,0,0,0,0,0,0,0,0
0,450,450,450,450,450,450,450,450,450,450,450,450,450,0
0,450,441,441,441,441,441,441,441,441,441,441,441,441,0
0,450,441,441,441,441,441,441,441,441,441,441,441,441,0
0,450,441,441,441,441,441,441,441,441,441,441,441,441,0
0,450,441,441,441,441,441,441,441,441,441,441,441,441,0
0,450,441,441,441,441,441,441,441,441,441,441,441,441,0
0,450,441,441,441,441,441,441,441,441,441,441,441,441,0
0,450,441,441,441,441,441,441,441,441,441,441,441,441,0
0,0,0,0,0,0,0,0,0,0,0,0,0,0,0
