0,0,0,0,0,0,0,0,0,0,0,0,0,0
0,0,0,0,1383,1383,0,0,0,0,0,1073,0,0
0,1401,1402,1388,0,0,1388,1388,924,0,0,1081,0,0
0,0,0,0,0,0,0,1388,0,0,0,0,0,0
0,1405,1405,0,0,1388,1388,0,1388,0,942,0,0,0
0,0,0,0,0,0,0,0,0,0,0,0,1625,0
0,0,0,0,0,0,0,0,0,0,0,0,1489,0
0,1625,0,0,0,0,0,0,0,0,0,0,1497,0
0,1509,0,0,0,0,0,0,0,0,0,0,1496,0
0,1517,0,0,0,0,0,0,0,0,0,0,0,0
0,0,0,0,0,0,0,0,0,0,0,0,0,0
0,0,0,0,0,0,0,0,0,0,0,0,0,0
