0,0,0,0,0,0,0,0,0,0,0,0,0,0
0,0,0,0,0,0,0,0,0,0,0,0,0,0
0,0,0,0,25,25,0,0,0,0,0,0,25,0
0,0,0,0,1399,1399,0,0,0,933,904,0,1347,0
0,0,0,0,0,0,0,0,0,0,912,0,0,0
0,0,0,0,0,0,0,0,0,0,0,0,0,0
0,1421,1421,0,812,813,813,813,813,814,0,0,0,0
0,0,0,0,820,821,821,821,821,822,0,0,0,0
0,0,0,0,828,829,829,829,829,830,0,0,0,0
0,0,0,0,0,1241,0,1243,0,1245,0,0,0,0
0,0,0,0,0,1249,0,1251,0,1253,0,0,0,0
0,0,0,0,0,0,0,0,0,0,0,0,0,0
