0,0,0,0,0,0,0,0,0,0,0,0,0,0,0,0,0
0,0,0,0,0,0,0,0,0,0,0,0,0,0,0,0,0
0,0,0,0,146,0,0,0,0,0,0,0,0,0,0,0,0
0,0,0,0,1139,0,0,0,0,0,1225,0,1227,0,0,0,0
0,0,888,764,765,766,0,0,0,0,1233,0,1235,0,885,0,0
0,0,0,772,773,774,1140,1141,0,0,0,0,0,0,0,0,0
0,0,0,772,773,774,0,0,0,0,0,0,0,0,0,1326,0
0,0,0,772,773,774,1140,1141,0,0,0,0,0,0,0,0,0
0,0,0,772,773,774,0,0,0,0,0,0,0,0,0,0,0
0,0,0,780,781,782,1140,1141,0,0,0,0,0,0,0,0,0
0,0,0,0,0,0,0,0,0,0,1769,1770,1770,1771,0,0,0
0,0,0,0,0,0,0,0,0,0,0,0,0,0,0,0,0
