419,420,419,420,419,420,419,420,419,420,419,420,419,420,419,420,419,420,419,420,419,420,419,420,419,420,419,420,419,420,419,420,419,420,419,420,419,420,419,420,419,420,419,420,419,420,419,420,
427,428,427,428,427,428,427,428,427,428,427,428,427,428,427,428,427,428,427,428,427,428,427,428,427,428,427,428,427,428,427,428,427,428,427,428,427,428,427,428,427,428,427,428,427,428,427,428,
419,420,419,420,419,420,419,420,419,420,419,420,419,420,419,420,419,420,419,420,419,420,419,420,419,420,419,420,419,420,419,420,419,420,419,420,419,420,419,420,419,420,419,420,419,420,419,420,
427,428,427,428,427,428,427,428,427,428,427,428,427,428,427,428,427,428,427,428,427,428,427,428,427,428,427,428,427,428,427,428,427,428,427,428,427,428,427,428,427,428,427,428,427,428,427,428,
419,420,419,420,419,420,419,420,419,420,419,420,419,420,419,420,419,420,419,420,419,420,419,420,419,420,419,420,419,420,419,420,419,420,419,420,419,420,419,420,419,420,419,420,419,420,419,420,
427,428,427,428,427,428,427,428,427,428,427,428,427,428,427,428,427,428,427,428,427,428,427,428,427,428,427,428,427,428,427,428,427,428,427,428,427,428,427,428,427,428,427,428,427,428,427,428,
419,420,419,420,419,420,435,436,435,436,435,436,435,436,435,436,435,436,435,436,435,436,435,436,435,436,435,436,435,436,435,436,435,436,435,436,435,436,435,436,435,436,419,420,419,420,419,420,
427,428,427,428,427,428,0,0,0,0,524,0,476,0,0,0,0,0,524,0,0,0,0,0,0,476,0,0,0,0,0,0,0,0,0,0,1273,0,0,0,0,0,427,428,427,428,427,428,
419,420,419,420,419,420,0,0,0,0,0,0,0,0,0,0,0,0,0,476,0,0,0,0,0,0,0,0,0,476,0,0,0,0,0,0,1281,0,0,0,524,0,419,420,419,420,419,420,
427,428,427,428,427,428,476,0,0,0,0,0,0,0,0,0,1585,1586,1587,1588,1589,476,0,0,1585,1586,1587,1588,1589,0,0,0,0,0,476,0,1281,0,0,0,0,0,427,428,427,428,427,428,
419,420,419,420,419,420,0,0,0,1793,1794,1795,1796,0,0,0,1593,1594,1595,1596,1597,0,0,0,1593,1594,1595,1596,1597,0,0,0,0,0,0,0,1291,1298,1298,1299,0,955,419,420,419,420,419,420,
427,428,427,428,427,428,0,0,0,1801,1802,1803,1804,0,0,0,1601,1602,1603,1604,1605,0,0,0,1601,1602,1603,1604,1605,0,0,0,0,0,0,0,0,0,476,0,0,0,427,428,427,428,427,428,
419,420,419,420,419,420,0,476,0,1809,1810,1811,1812,0,0,0,1609,1610,1611,1612,1613,971,0,971,1609,1610,1611,1612,1613,954,0,0,0,524,0,0,0,0,0,0,0,0,435,436,435,436,435,436,
427,428,427,428,427,428,0,0,0,0,0,0,0,0,0,0,0,0,0,0,0,0,0,0,0,0,0,0,0,0,0,0,0,0,0,0,0,0,0,0,0,0,0,0,0,0,0,0,
419,420,419,420,419,420,0,0,0,0,0,0,0,0,0,0,0,0,0,0,0,0,0,0,0,0,0,0,0,0,0,0,0,0,0,0,0,0,0,0,0,0,0,0,0,0,0,0,
427,428,427,428,427,428,0,0,0,0,0,0,0,0,0,0,0,0,0,0,0,0,0,0,0,0,0,0,0,0,0,0,0,0,0,0,0,0,0,0,0,0,0,0,0,0,0,0,
419,420,419,420,419,420,0,0,0,0,0,958,0,1297,1298,1298,1299,0,0,1297,1298,1298,1298,1298,1299,0,476,0,0,0,1275,1298,1298,1298,1298,1299,0,0,0,0,0,0,0,0,0,0,0,0,
427,428,427,428,427,428,0,0,0,0,0,1274,0,0,0,524,1545,1546,1547,1548,1549,476,0,0,0,0,0,0,0,0,1281,998,998,998,998,998,0,0,0,0,0,0,427,428,427,428,427,428,
419,420,419,420,419,420,0,0,0,0,0,1282,0,0,0,0,1553,1554,1555,1556,1557,0,0,0,1505,1506,1507,1508,1509,1510,1289,0,0,954,0,0,0,0,0,0,0,0,419,420,419,420,419,420,
427,428,427,428,427,428,0,0,0,0,0,1290,0,0,0,0,1561,1562,1563,1564,1565,0,0,0,1513,1514,1515,1516,1517,1518,0,0,0,0,0,0,0,0,0,0,0,0,427,428,427,428,427,428,
419,420,419,420,419,420,0,0,0,0,0,0,1297,953,1299,971,1569,1570,1571,1572,1573,954,0,971,1521,1522,1523,1524,1525,1526,0,0,0,0,0,0,0,0,0,0,0,0,419,420,419,420,419,420,
427,428,427,428,427,428,0,0,0,0,0,0,0,0,0,0,0,0,0,0,0,0,0,0,0,0,0,0,0,0,524,0,0,0,0,0,0,0,0,0,0,0,427,428,427,428,427,428,
419,420,419,420,419,420,476,0,0,0,0,0,0,0,0,0,0,0,0,0,0,0,0,0,0,0,0,0,0,0,0,0,0,0,0,0,0,0,0,0,0,0,419,420,419,420,419,420,
427,428,427,428,427,428,0,0,1297,1298,1298,1298,1298,1299,0,524,1297,1298,1298,1298,1299,0,1297,1298,1298,1298,1298,1298,1298,1299,0,0,0,0,0,0,0,0,0,0,0,0,427,428,427,428,427,428,
419,420,419,420,419,420,0,0,0,0,0,476,0,0,0,0,0,0,0,0,0,0,0,0,0,0,0,0,0,0,524,0,0,0,0,0,0,0,0,0,0,0,419,420,419,420,419,420,
427,428,427,428,427,428,427,428,427,428,427,428,427,428,427,428,427,428,427,428,427,428,427,428,427,428,427,428,427,428,427,428,427,428,427,428,427,428,427,428,427,428,427,428,427,428,427,428,
419,420,419,420,419,420,419,420,419,420,419,420,419,420,419,420,419,420,419,420,419,420,419,420,419,420,419,420,419,420,419,420,419,420,419,420,419,420,419,420,419,420,419,420,419,420,419,420,
427,428,427,428,427,428,427,428,427,428,427,428,427,428,427,428,427,428,427,428,427,428,427,428,427,428,427,428,427,428,427,428,427,428,427,428,427,428,427,428,427,428,427,428,427,428,427,428,
419,420,419,420,419,420,419,420,419,420,419,420,419,420,419,420,419,420,419,420,419,420,419,420,419,420,419,420,419,420,419,420,419,420,419,420,419,420,419,420,419,420,419,420,419,420,419,420,
427,428,427,428,427,428,427,428,427,428,427,428,427,428,427,428,427,428,427,428,427,428,427,428,427,428,427,428,427,428,427,428,427,428,427,428,427,428,427,428,427,428,427,428,427,428,427,428,
419,420,419,420,419,420,419,420,419,420,419,420,419,420,419,420,419,420,419,420,419,420,419,420,419,420,419,420,419,420,419,420,419,420,419,420,419,420,419,420,419,420,419,420,419,420,419,420,
427,428,427,428,427,428,427,428,427,428,427,428,427,428,427,428,427,428,427,428,427,428,427,428,427,428,427,428,427,428,427,428,427,428,427,428,427,428,427,428,427,428,427,428,427,428,427,428